Tastenbelegung NC 1.2 - 22.11.2009
----------------------------------

Space	Datei markieren / Markierung aufheben (Anzeige durch ! statt .)
0-9	USER-Bereich direkt einstellen
A	Attribute setzen/ruecksetzen
B
C	Copy (Datei/en kopieren)
D	Delete (Datei/en loeschen)
E	Edit, Aufruf ZDE (oder TPKC)
F
G	Gruppenkommando auf Dateien anwenden (z.B. MPUT $1)
H	Hilfe
I	Info anzeigen
J
K	KCC-Hexdump
L	Laufwerk wechseln, belegte User-Bereiche werden angezeigt
M	Maske (Dateimaske eingeben)
N
O	mOve (Datei/en verschieben)
P	Print (Textdatei Drucken)
Q	Quit (Programmende)
R	Rename (Datei umbenennen)
S	Stamps (Datum) ein/aus
T	Type (Textdatei anzeigen)
U
V	View (Bilddatei anzeigen)
W	Gruppe Dateien markieren/unmarkieren
X	heXdump anzeigen
Y
Z	Kommandozeile eingeben (CP/M Promt)
